the	il-lo-la-i-gli-le
black	nero
droid	droide
droids	droidi
then	quindi
lowers	abbassa
mask	maschera
and	e
helmet	elmetto
onto	sulla
his	suo-sua-suoi-sue
head	testa
these	questi-queste
are	sono-sei
not	non
youre	sei-stai
looking for	cercando
looking	guardando
for	per
your	tuo-tuoi
may	posso-puoi-pu√≤-possiamo-potete-possono
escape	scappare
but	ma
you	tu
doomed	condannato
's	di
friend	amico
friends	amici
're	stai-state